Tilahun Gessesse	ጥላሁን ገሠሠ
Michael Jackson	ማይክል ጃክሰን
Aleksandr Solzhenitsyn	አሌክሳንድር ሶልዠኒጽን
Gerald Ford	ጄራልድ ፎርድ
Tsegaye Gabre-Medhin	ጸጋዬ ገብረ መድህን
Naguib Mahfouz	ናጊብ ማህፉዝ
Fahd of Saudi Arabia	ንጉስ ፋህድ
Milton Obote	ሚልተን ኦቦቴ
Ronald Reagan	ሮናልድ ሬገን
Haddis Alemayehu	ሀዲስ ዓለማየሁ
Léopold Sédar Senghor	ሊኦፖልድ ሴዳር ሴንጎር
Asrat Woldeyes	አስራት ወልደየስ
Alex Haley	አሌክስ ሄሊይ
Mengistu Lemma	መንግስቱ ለማ
Indira Gandhi	ኢንድራ ጋንዲ
Mikhail Aleksandrovich Sholokhov	ሚካኤል ሾሎኮቭ
Anna Nagata	አና ናጋታ
Usher (entertainer)	ኧሸር
Jomo Kenyatta	ጆሞ ኬኒያታ
Khalid Adem	ካሊድ አደም
Birtukan Mideksa	ብርቱካን ሚዴቅሳ
Haile Selassie I of Ethiopia	ቀዳማዊ፡ኃይለ፡ሥላሴ
Robel Teklemariam	ሮቤል ተክለማርያም
Sergey Brin	ሰርጂ ብሪን
Haile Gebrselassie	ኃይሌ ገብረ ሥላሴ
Abebe Bikila	አበበ ቢቂላ
Pearl S. Buck	ፐርል በክ
Amílcar Cabral	አሚልካር ካብራል
Pablo Neruda	ፓብሎ ኔሩዳ
Derartu Tulu	ደራርቱ ቱሉ
Ezra Pound	እዝራ ፓውንድ
Anna Akhmatova	አና አኽማቶቫ
T. S. Eliot	ቲ.ኤስ. ኤልየት
Moussa Dadis Camara	ሙሳ ዳዲ ካማራ
Courtney Love	ኮርትኒ ላቭ
Herbert Hoover	ሄርበርት ሁቨር
John F. Kennedy	ጆን ኤፍ ኬኔዲ
Barack Obama	ባራክ ኦባማ
Ernest Hemingway	ኧርነስት ሄሚንጔይ
Diego Maradona	ማራዶና
Abebe Aregai	አበበ አረጋይ
Berhanu Nega	ዶ/ር ብርሃኑ ነጋ
Michael Jackson	ማይክል ጃክሰን
User:Realist2/MJ pre death	ማይክል ጃክሰን
Robert Ehrlich	ሮበርት ኢርሊክ
Meles Zenawi	መለስ ዜናዊ
Tamirat Layne	ታምራት ላይኔ
Idriss Déby	እድሪስ ዴቢ
Jay Leno	ጀይ ለኖ
Mohandas Karamchand Gandhi	ማህተማ ጋንዲ
Hillary Rodham Clinton	ሂለሪ ሮድሃም ክሊንተን
Paulo Coelho	ፓውሎ ኮሄሎ
Ismail Omar Guelleh	እስማኤል ኦማር ገለህ
Sofia Rotaru	ሶፊያ ሮታሩ
Isaias Afewerki	እሳያስ አፈወርቂ
George W. Bush	ጆርጅ ደብሊዩ ቡሽ
Bill Clinton	ቢል ክሊንተን
Adolf Hitler	አዶልፍ ሂትለር
Franklin D. Roosevelt	ፍራንክሊን ሮዘቨልት
Omar al-Bashir	ኦማር ሀሳን አህመድ አል-በሽር
Ama Ata Aidoo	አማ አታ አዪዶ
José Eduardo dos Santos	ሆዜ ኤድዋርዶ ዶስ ሳንቶስ
Rabindranath Tagore	ራቢንድራናት ታጎር
Tilahun Gessesse	ጥላሁን ገሠሠ
Muhammad Yunus	ሙሃመድ ዩኑስ
Ayi Kwei Armah	አዪ ኩዌ አርማህ
Connie Francis	ኮኒ ፍራንሲስ
Ngugi wa Thiong'o	ንጉጊ ዋ ቲዮንጎ
Muhammad Iqbal	አላማ ኢቅባል
Heruy Welde Sellase	ኅሩይ ወልደሥላሴ (ብላቴን ጌታ)
Mengistu Haile Mariam	መንግስቱ ኃይለ ማርያም
Tsegaye Gabre-Medhin	ጸጋዬ ገብረ መድህን
Tesfaye Gessesse	ተስፋዬ ገሠሠ
Maxim Gorky	ማክሲም ጎርኪ
Iyasu V of Ethiopia	እያሱ 5ኛ
Wole Soyinka	ዎሌ ሾይንካ
Abebe Bikila	አበበ ቢቂላ
Mwai Kibaki	ሙአይ ኪባኪ
Toni Morrison	ቶኒ ሞሪሰን
Chinua Achebe	ቺኑዋ አቼቤ
Zewditu I of Ethiopia	ንግሥተ ነገሥታት ዘውዲቱ
Asrat Woldeyes	አስራት ወልደየስ
Hosni Mubarak	ሆስኒ ሙባረክ
Gabriel García Márquez	ጋብሬል ጋርሺያ ማርኬዝ
Milton Obote	ሚልተን ኦቦቴ
Margaret Thatcher	ማርጋሬት ታቸር
George H. W. Bush	ጆርጅ ኤች ቡሽ
Amílcar Cabral	አሚልካር ካብራል
Girma Wolde-Giorgis	ግርማ ወልደ ጊዮርጊስ
Kenneth Kaunda	ኬኔት ካውንዳ
Mengistu Lemma	መንግስቱ ለማ
Daniel arap Moi	ዳንኤል አራፕ ሞይ
Nadine Gordimer	ናዲን ጎርድመር
Fahd of Saudi Arabia	ንጉስ ፋህድ
Alex Haley	አሌክስ ሄሊይ
Nelson Mandela	ኔልሰን ማንዴላ
